111111111111111111111111
1000000111100000C0000EE1
101100C00010011111110001
100P0001110000000C000001
1001100000C00PC011110001
111111111111111111111111
