111111111111111111111111
1000000111100000000000E1
101100000010011111110001
100P00011100000000000001
10011000000000C011110001
111111111111111111111111
