111111111111111111111111
100000000000000P0C0E0001
101100000010011111110001
100000111000000000000001
100110000000000011110001
111111111111111111111111