111111111111111111111111
10000CCC0000P0000C0C00E1
101100000000000000000001
100001000011111111110001
100100011000000000000001
111111111111111111111111
111111111111111111111111
111111111111111111111111
111111111111111111111111
