111111111111111111111111
1000000111100000C0000E01
101100C00010011111110001
1000001110000000C0000001
1001100000C00PC011110001
111111111111111111111111
