11111111111111111111111111
10010000000000000000000001
10010111100000000000000001
100100000000P0000000000001
100100000000C0000000111101
100100000000C0000000000001
100100000000C0000000000001
100001111100C0000000000001
1P0011E00000C0000000000001
11111111111111111111111111