1111111111111111
1111111111111111
1111111111111111
1001000000000001
1001011110000001
1001000000000001
1001000000000001
1001000000000001
1001000000000001
1000011111000001
1P00E10000000011
111111C111111111
1111111111111111
1111111111111111
1111111111111111
1111111111111111
1111111111111111
1111111111111111
1111111111111111
1111111111111111
1111111111111111
1111111111111111
1111111111111111
1111111111111111
1111111111111111
1111111111111111
1111111111111111
1111111111111111
1111111111111111
1111111111111111
1111111111111111
1111111111111111
1111111111111111