11111111111111111111111111111111111111
1000000CCCCCECC00CCCCCCCCC000000000P01
11111111111000111111111111111000000001
11111111111111111111111111111111111111