1111111111111111111111
1000000P00000000000011
1000000000000000000011
1111111011101010001011
1000111000000010111011
1010101011000000101011
1110111010001010111011
100000C000C00000CC00E1
1111111111111111111111
