1111111111111111111111111111111111111111111111111111111111111111
1000000000000000000000000000000000000001010000000000000000000001
1000000000000000000000000000000000000000000000000000000000000001
1000000000000000000000000000000000000000000000000000000000000001
1000000000000000000000000000000000000000000000010000000000000001
100000000000000E0000000000000000000000000000001P1000000000000001
1000000000000000000000000000000000000000000000010000000000000001
1000000000000000000000000000000000000000000000000000000000000001
10000000000C0000000000000000000000000000000000000000000000000001
100000000000C000000000000000000000000000000000000000000000000001
1000001110000C00000000000000000000000000000000000000000000000001
1111111111111111111111111111111111111111111111111111111111111111