1111111111111111111111111111111111111111111111111111111111111111111111111111111111
1000000000000000000000000000000000000000E00000000000000000000000000000000000000001
1000000000000000000000000000000000000000000000000000000000000000000000000000000001
1000000000000000000000000000000000000000000000000000000000000000000000000000000001
1000000000000000000000000000000000000000000000000000000000000000000000000000000001
1000000000000000000000000000000000000000000000000000000000000000000000000000000001
1000000000000000000000000000000000000000000000000000000000000000000000000000000001
1000000000000000000000000000000000000000000000000000000000000000000000000000000001
10000000000C0000000000000000000000000000000000000000000000000000000000000000000001
100000000000C000000000000000000000000000000000000000000000000000000000000000000001
1000001P10000C00000000000000000000000000000000000000000000000000000000000000000001
1111111111111111111111111111111111111111111111111111111111111111111111111111111111