11111111111111111111111111111111111111111111111111111111111111111111111111111111111111111111111111111111111111111111111
10000000000000000000000000000000000000000000000000000000000000000000001010000000000000000000001010000000000000000000001
10000000000000000000000000000000000000000000000000000000000000000000001010000000000000000000001010000000000000000000001
10000000000000000000000000000000000000000000000000000000000000000000001010000000000000000000001010000000000000000000001
10000000000000000000000000000000000000000000000000000000000000000000001010000000000000000000001010000000000000000000001
10000000000000000000000000000000000000000000000000000000000000000000001010000000000000000000001010000000000000000000001
10000000000000000000000000000000000000000000000000000000000000000000001010000000000000000000001010000000000000000000001
10000000000000000000000000000000000000000000000000000000000000000000000000000000000000000000010100000000000000000000001
100000000000000000000000000000E00CCC0000000000P0000000000000000000000010100000000C0000000000000000000000000000000000001
10000000000000000000000000000000000000000000000000000000000000000000001010000000000000000000001010000000000000000000001
10000000000000000000000000000000000000000000000000000000000000000000001010000000000000000000001010000000000000000000001
10000000000000000000000000000000000000000000000000000000000000000000001010000000000000000000001010000000000000000000001
10000000000000000000000000000000000000000000000000000000000000000000001010000000000000000000001010000000000000000000001
10000000000000000000000000000000000000000000000000000000000000000000001010000000000000000000001010000000000000000000001
10000000000000000000000000000000000000000000000000000000000000000000001010000000000000000000001010000000000000000000001
11111111111111111111111111111111111111111111111111111111111111111111111111111111111111111111111111111111111111111111111