11111111111111111111111
1111111PCCCCCC0CCCCC111
111111110000001111E1111
11111111111111111111111
11111111111111111111111