111111111111111111111111
100000000000000P0C0C00E1
101100000000000000000001
100001000011111111110001
100100011000000000000001
111111111111111111111111