111111111111111111111111111
111111101111111111111111111
11111PCCCC00E11111111111111
111111111111111111111111111
111111111111111111111111111
111111111111111111111111111
111111111111111111111111111